1......GGGA....GG...
....---####-...-##..
..GG.............A..
..#-.............-##
......GGGGAG...A....
......------..----..
..GGG...............
..---....AGGGG......
........#####--.....
.......---..........
....GGG...##A.GGG...
....---.A..####--...
...-...####.........
...########......AX.
####################
