1...................
....................
....................
....................
......GGGGGG........
......######........
..GGG...............
..---....AGGGG......
........#######.....
.......---..........
....GGG...##..GGG...
....---....######...
...-...####.........
...########......AX.
####################
