....................
....................
..........X.........
.......######.......
A.G..............G.A
####..G.G.G.G....###
.......G.G.GAG......
......--------......
...--...........--..
....................
AG.G............GAG.
####.....##.....####
....................
.1....GGGGGGGGG.....
####################
