....................
...G............X...
...--..G.......--...
...AG.--.......AG...
...--..........--...
...G.....AG....G....
...--....--....--...
...AG..#...#....G...
...--...#.#..G.--...
...G.....#..--.G....
...--.....#....--...
...AG......#....G...
...--.......#..--...
.1........A..#......
####################
